███████████████████████
██    ████♠████       █
██ ██ ████ ████ ███████
█   █   ██            █
█ █ █ █ █  ███ █ █ ██ █
█ █   █   ████ █ █ ██ █
█ ██ ████      █ █ ██ █
█ ██ ████ ███ ██ █    █
█         █      ███ ██
█ ███████ █ ████ ███ ██
█         █ ████ █    █
█ ██ ██ ███      █ ██ █
█ ██ ██ █████ ████ ██ █
█1      █2         ██ █
█ ███████ █ █ █ █ ███ █
█ █       █   ███ ██  █
█ ███████████ █   ██ ██
█         █ █ █ ███  ██
████ ██████   █   █ ███
█           ███ █   ███
█████████████ █████ ███
█     3     █ █ █     █
██████████        ███ █
█████████████████████F█
███████████████████████